How I Started 5 Successful Side Projects Without Burning Out 

right off: ngay lập tức
announcement: thông báo
accomplish: hoàn thành
rush to the office: vội vàng tới văn phòng
heading home: về nhà
barely: vừa đủ
barely have time: hầu như không có đủ thời gian
barely finish: vừa mới hoàn thành
mess: bừa bộn
supposed: giả sử
launched: thành lập
renovated: sửa sang
several week-long photography: hội thảo nhiếp ảnh kéo dài 1 tuần
distilled: chat lọc
acronym: viết tắt
former: cựu
positive: tích cực
meditate: thiền, thư giãn
falls apart: tan rã
apart: riêng biệt
wellness: sự khỏe mạnh
whether: cho dù
substantial: đáng kể
chip away at over time: loại bỏ dần dần theo thời gian
couple of tips: một vài lời khuyên
tactical and strategic: chiến thuật và chiến lược

doing stuff: làm việc
willpower: ý chí
raging success: thành công rực rỡ
bucket: nhóm
a third: một phần ba
neglect: sao nhãng
sustainable: bền vững
sacrifice: hy sinh cho gì đó
bound to fail: chắc chắn thất bại
compensation: bồi thường
come by: đi qua
assessment: đánh giá
serious: nghiêm túc, nghiêm trọng
some capital: một số vốn
kindness: lòngg tốt
charity: từ thiện
lesson: bài học
aggressively: tích cực
There's typically: thông thường có
guilty: tội lỗi
decent: tử tế, tốt
declined: từ chối
straight up: lập tức
distracted: phân tâm
confession: thú nhận