The end of the _Self-Taught Programmer_ - English.txt

landscape: phong cảnh
ever been in: đã từng ở
ever since: kể từ đó
somehow = someway
through/throught: bởi vì/ xuyên suốt/ xuyên qua
though/thought: bởi vì/ suy nghĩ
lottery: vé số
terrible: kinh khủng
reach: với tới
reach out: tiếp cận
acknowledge: thừa nhận
convince: thuyết phục
compete: hoàn thành
competitive: cạnh tranh
competing: cạnh tranh
grads=graduates
stand out: nổi bật
qualified: tiêu chu
qualifications: bằng cấp
proper: thích hợp
recipe: công thức
ground up: nền tang
hobby: sở thích
so on and so forth: vân vân và vân vân = etc
slightly: nhẹ nhàng
exposure = expose
laid off = lay off
laid out: đặt ra
lay out: cách trình bày
sign: dấu hiệu
signing/signed: kí
signification/significantly: có ý nghĩa / đáng kể

