turbulent: hỗn loạn
courage: can đảm
leap: nhảy vọt
acquired: tích lũy
newsletter: bản tin
casual: bình dân, bình thường
purchased: đã được mua
bet: cá cược
tough: khó khăn
desperate: tuyệt vọng
properly: đúng cách
property: tài sản
formerly owned: trước đây sở hữu
asymmetric: bất đối xứng
compensation: mức lương
comparatively: tương đối
a pat on the back: một cái vỗ vai
precursor: tiền thân
apologist: người bào chữa
treat: đối xử
evil: xấu xa
delight: hài lòng
tunnel: xa, đường hầm
solely: chỉ để
everything in between: mọi thứ liên quan
pay: trả
wire: mặc
wireless: không dây
valuation = evaluate: định giá
sold out instantly: bán hết ngay lập tức
issue a recall: ban hành lệnh thu hồi
cash crunch: khó khăn về tiền mặt
sunk: chìm, nhấn chìm
themselves invented: chính họ phát minh ra
decisively: dứt khoát
taking a big swing: thực hiện một bước tiến lớn
big upside: thành công lớn, tích cực lớn
Just make it already: cứ làm đi đã
painful to unwind: đau đớn để thư giãn
angles: góc độ
proceed: tiếp tục
harm: tổn hại
agonize: đau khổ
How long: mất bao lâu
chuckled: cười khúc khích
guess what: đoán xem
striving: phấn đấu
take time away: mất đi thời gian
wealth: giàu
take naps: ngủ trưa
epic photo: bức ảnh hoành trnág
profits: lợi nhuận
expenses: chi phí
false sense: cảm giác sai lầm
terminology: thuật ngữ
stay up to date on things: luôn cập nhật về mọi thứ
gone: đi mất, rời đi
filled up : lấp đầy
It turns out that there's this thing: hóa ra là có thứ này
allott/allotted: dành ra, phân bổ
beware: cẩn thận
put away: cất đi, dấu đi
intentional and disciplined: chủ ý và kỷ luật
regret: hối hận, hối tiếc
employ/employed: áp dụng
point of life: mục đích của cuộc đời
accrued=accumulation: tích lũy
courage: can đảm
