How To Prepare For Frontend Web Dev Interviews

conducted: thực hiện
There generally: nhìn chung
stuff: những thứ
became a thing: trở thành hiện thực
some sort: một số loại
extent: mức độ, phạm vi
There are all kinds of people: có đủ loại người
make things up: bịa đặt
intuition: trực giác, cảm nhận
brought up: đề cập
was bullshitting them: đang nói nhảm về chúng
nervous and confused: lo lắng và bối rối
seasoned: dày dạn kinh nghiệm
instantly tell: ngay lập tức biết
admit: thừa nhận
freaked out daily: cảm thấy lo lắng hằng ngày
but rather: đúng hơn là

You Dont Need Microservices

spec: thông số kĩ thuật
freak out: bối rối
which is mind-blowing: một điều đáng kinh ngạc
adopt serverless or not: sử dụng serverless hay không
intense: mãnh liệt
from scratch: từ đầu
the sake: lợi ích
turning point: bước ngoặc
makes sense: hợp lý
aims: nhằm
aims to address: nhằm mục đích giải quyết
smash = press: nhấn vào
