What Entry-Level Developers Should Focus on (The Developer Brand Pyramid)

conclude: kết luận
portion of the partitions: phần của phân vùng
ingest: ăn vào, nuốt vào
Resilient: đàn hồi
flooded: tràn ngập
stand out: nổi bật
cultivating: xây dựng, trồng trọt
employer/employers: nhân viên/ nhà tuyển dụng
signal: báo hiệu
showcase: thể hiện
pyramid: kim tự tháp
crucial: chủ yếu, quan trọng
solid: vững chắc, chất rắn
authority: quyền lực
attractive: hấp dẫn
judge: phán xét
suffice: đủ
verbatim: nguyên văn, nguyên bản, y hệt
crafting: chế tạo, thực hiện
set you apart: làm bạn khác biệt
out there: ngoài kia
lean on: dựa vào
thoroughly: triệt để, kỹ lưỡng
it's inevitable: chắc chắn
bachelor's degree/qualifications: bằng cử nhân
tend: có khuynh hướng, đạt được
biggest funnel: ống khói lớn nhất
pivotal: then chốt, quan trọng
presence: hiện diện
competency: năng lực
solely relying: chỉ dựa vào
spray-and-pray: phun và cầu nguyện
massively handicapping yourself: tự gây bất lợi lớn cho mình
enriched: được làm giàu
serve as: đóng vai trò như, phục vụ như
even though: mặc dù
express: bày tỏ
explicitly stated: tuyên bố rõ ràng
sort of: đại loại, có vẻ
It sort of comes off as desperate: nó có vẻ tuyệt vọng
competence: năng lực
