velocity: vận tốc
subjective: chủ quan
subject: chủ đề
beat that: đánh bại nó
drag your feet: kéo chân bạn
dipped a bit: nhúng vào một chút
trigged by: kích hoạt bởi
tailored: phù hợp
elevate/elevated: nâng/cao
likelihood: khả năng xảy ra
crash: sự cố
watch out: coi chừng
debt: món nợ
sneak: lén lút
as well: như vậy
arguments: tranh luận
argument: lý lẽ
permanently: Vĩnh viễn
stay away: tránh xa
considerable: đáng kể
unless: trừ khi
appreciate/appreciated: đánh giá/đánh giá cao
courage: can đảm
upset: buồn bã
species: giống loài
disappoint/disappointment: sự thất vọng
appointment: cuộc hẹn
equip/equipment: trang bị/thiết bị
spec: thông số kỹ thuật
one debt to society later: một món nợ cho xã hội sau này
frustrated:
objectively