slapping: tát
firecracker: pháo nổ
relieves you: làm bạn nhẹ nhõm
versed/competently/fluent: thành thạo
imposter: kẻ mạo danh
echoing: vang vọng
twice as productive: năng xuất gấp đôi
conference: hội nghị
in doubts: nghi ngờ
doubs: gấp đôi
subsides concern: giảm bớt mỗi quan tâm
argued=argument: tranh luận
no loss: không mất mát
defect rate: tỷ lệ lỗi
a fad: một mốt nhất thời
ugly: xấu xí
awareness: nhận thức
adopts: thông qua

rose to dominate: vươn lên thống trị
deallocate: giải quyết
prerequisite: điều kiện tiên quyết
requisite: điều cần thiết
decision: phán quyết
inevitably: tất yếu, không thể tránh khỏi
gets rid: thoát khỏi
curated: tuyển chọn
curriculum: chương trình giảng dạy
inherent/inherently: vốn có
seek: tìm kiếm
laid out: đặt ra
industry adoption: áp dụng vào ngành công nghiệp
is here to stay: đây là điểm dừng