junkie: đam mê, nghiện
distill: chắt lọc
exclusive: loại trừ, độc quyền
conducted: tiến hành, chỉ đạo
dry spell: tình trạng khô hạn
sequentially: tuần tự
concentrate: tập trung
tinkering: mày mò
caught up: bắt kịp
drawbacks/drawback: nhược điểm, hạn chế
altitude: độ cao
invert: đảo ngược
swing: xích đu
literally: theo đúng nghĩa đen
stale: cũ
demoralizing: làm mất tinh thần
artifact: hiện vật
overly ambitious/ambition: quá tham vọng
upfront: trả trước
solid/solidify/solidity: rắn chắc/ làm cứng lại/ sự vững chắc

can't stand your job: không thể chịu đựng công việc
brushing up: nâng cao
transcript: bảng điểm
job hunting: tìm việc .. head hunter: thợ săn đầu người
dread: kinh sợ
pain: nỗi đau, thất bại
thrive: phát triển
suppose: giả sử
figure out: tìm ra
i figure: tôi nghĩ
adjacent role: vai trò liền kề
along: dọc theo, cùng
passive: thụ động
turn me down/turned me down: từ chối tôi/ làm tôi thất vọng
tangible output: đầu ra hữu hình
time boxed: đóng hộp thời gian
hold out and wait: cầm cự và chờ đợi