shifting: chuyển dịch
hype/hyper: đẹp đẽ, cường điệu
orphan: mồ côi
intercept/intercepts: chặn
intercepted: bị chặn
interception: đánh chặn
compromise: thỏa hiệp
compromised: bị xâm phạm
obsolete: lỗi thời
transmiss: truyền đi
claims: đòi hỏi
successor: người kế nhiệm
against: dựa trên
tamper/forgery: giả mạo
eavesdropping: nghe trộm

victim: nạn nhân
breach: vi phạm
incident: sự cố
investigation: cuộc điều tra
fraud: gian lận, lừa đảo
legitimate/legal: hợp pháp
phishing site: trang lừa đảo
assure/assured/rest assured: cam đoan/yên tâm/yên tâm
obtained/obtained from: thu được, thu được từ
issued by/is issued: phát hành bởi/ được ban hành
impersonates: mạo danh
cipher text: văn bản mật mã
nist: ý kiến
heats up pressures: làm nóng áp lực
automate: tự động hóa
transit/transitive: quá cảnh, bắt cầu
transition: chuyển tiếp