KISS, SOLID, CAP, BASE: Important Terms You Might Not Know!

distinguish: phân biệt
can span: có thể vượt qua
external perspective: góc nhìn bên ngoài
unified: thống nhất
ubiquitous: phổ cập, có mặt mọi nơi
address: giải quyết
composition: thành phần
decomposition: phân hủy
evenly: đồng đều
attracts: thu hút
respective: tương ứng
resides: cư trú
character/characteristics: tính cách, đặc trưng
interleaved: xen kẽ
topology: cấu trúc liên kết
relays: chuyển tiếp

peer: đồng nghiệp/ngang hàng
fog: sương mù
eventual: cuối cùng
stand for: viết tắt của
resilience: khả năng phục hồi
segrege/segregetion: phân chia, tách biệt
aims: mục đích
tolerance: chịu đựng
acronym: viết tắt
extension: sự mở rộng
interfering: can thiệp
acquiring/acquire: có được, giành được
exclusive: loại trừ
exclusive lock: khóa độc quyền
gone: đi mất, đi qua
restricts: hạn chế
mitigate: giảm nhẹ
arise: phát sinh