Reading Good Books WILL CHANGE Your Life

income/paycheck: thu nhập
stagnant: trì trệ
wisdom: khôn ngoan
wreck: suy sụp
doomed: hủy hoại
pick up these notions: tiếp thu những quan niệm này
sway: ảnh hưởng
speak over and over: nói đi nói lại 
floating along in an unbelievably mind-blowing universe: trôi nổi trong 1 vũ trụ đáng khó tin
drying up: cạn kiệt
basis: nền tảng
nugget: hay ho, cục vàng, tốt đẹp
as well: cũng
cowering away: thu mình lại
hone: trau dồi
boldness: táo bạo
creative: sáng tạo
appreciation: sự đánh giá
sort of: đại loại
aside: ngoài, qua một bên
map them out to: vạch chúng ra để
glean: thu thập
crafted: chế tạo
fluff: rườm rà, dư thừa
and so on: vân vân
summed up: tóm tắt
fiction books: sách viễn tưởng
portray some sort: miêu tả một số loại
spark: khơi dậy
trait: đặc didểm
basking in your boredom: đắm mình trong sự buồn chán
Biographies: tiểu sử
shallow: nông cạn
exercising: tập thể dục
obligated: bắt buộc
burden: gánh nặng
shame: xấu hổ
raise->risen: tăng, đã tăng
reading corner: góc đọc sách
associate: kết hợp
