discount: giảm giá
pros and cons: ưu và nhược điểm
pissed: tức giận = angry
a chartered: một điều lệ
variation/variations: biến đổi, biến thể
variant: khác nhau
cater: phục vụ
optimistic: lạc quan
hear me out: hãy nghe tôi nói
irreplaceable: không thể thay thế
invaluable: vô giá
prime: xuất sắc
apologize: xin lỗi
immense: bao la
transmit: chuyển giao
mitigate: giảm nhẹ
gesture: cử chỉ

otherwise: nếu không thì
premise: tiền đề
meanwhile: trong khi đó
incentivized: được khuyến khích
proposition: dự luật
philosophy/philosopher: triết lý/nhà triết học
clerk: nhân viên văn phòng
citizen: công dân
alias/aliases: bí danh
unforseen: không lường trước được
uncertainty: không chắc chắn
recess/recession: giải lao/suy thoái
time ahead: thời gian trước
ahead of time: trước thời hạn
ahead: trước, trước đó

blew up: nổ tung
interpreting: phiên dịch
accelerate: thúc giục
giant: người khổng lồ
scrambling: sự xáo trộn
craft/crafted: thủ công/chế tạo
desperate: tuyệt vọng
negotiation/negotiate: thương lượng
compound: hợp chất