fascinate/fascinating: lôi cuốn, mê hoặc
obscure: mơ hồ
noise/loud: ồn ào
headed next: hướng tới tiếp theo
flight: chuyến bay
lineages: dòng dõi
garnered: thu được, thu hút
colleagues: đồng nghiệp
brilliant: xuất sắc
ecstatic: ngây ngất
ironically: trớ trêu thay, một cách mỉa mai
maturity: trưởng thành
soon enough: đủ sớm
brought: đem lại
brought up: đưa lên

incorporating/corporating: kết hợp, hợp tác
tight: chặt chẽ, thắt chặt
proximity: sự  gần gũi
depart: khởi hành
needless: không cần thiết
fostering: bồi dưỡng
throughtful: xuyên suốt
drawn: vẽ tranh
disruptive/discontinuity: gây rỗi/gián đoạn
postponing: trì hoãn, hoãn lại
shift/shifted: sự thay đổi/đã thay đổi, đã dịch chuyển
firmly: vững chắc
till this day: cho đến ngày nay
emphasis: nhấn mạnh

interoperability: khả năng tương tác
widespread: phổ biến rộng rãi
refine/refining: chắt lọc, tinh chế
dramatically: đáng kể
surge: dâng trào
global tragedy: bi kịch toàn cầu
steward: quản lý
nurturing: nuôi dưỡng
consecutive: liên tiếp
appeal: bắt mắt, hấp dẫn
devote: tận tâm
barrier: rào chắn
