definitely/definite: chắc chắn
definition: sự định nghĩa
pay off: trả hết
passing: đi qua, vượt qua
hint/hints: gợi ý
menital: tâm thần = mental
popular/popularity: phổ biến
population: dân số
Start Over: bắt đầu lại
glastic: thủy tinh
interupt: ngắt quãng
uninterupt: không gián đoạn
reinforce: tăng cường
cultivate: trồng trọt
personality: nhân cách
personal/personally: cá nhân, riêng tư

about to: sắp sửa
sink: chìm
what a time to be alive: thật là một thời đại dễ sống
Get familiar: làm quen
wjat is going on: những gì đang diễn ra
disappear: biến mất
so long ago: từ lâu
go far: tiến xa
surf FB: lướt FB
staying up all night: thức trắng đêm
therefore: do đó
pursue: theo đuổi
broken: hư, hỏng
consolidate: củng cố
master: bậc thầy

In terms of technology: về mặt kĩ thuật
according to: theo
mandatory: bắt buộc
just because: chỉ vì
useful: hữu ích
You will feel like an imposter: 
bạn sẽ thấy mình như kẻ mạo danh
inanimate: vô tri vô giác
take place: diễn ra
so: vì vậy
Someday: ngày nào đó
reasonable: hợp lý
what does it look like: trông như thế nào
receive: tiếp thu
