i kind of just start: tôi chỉ là mới bắt đầu
crushing: nghiền nát
backed it up: đã sao lưu nó
pursue: theo đuổi
glean: lượn lặt
salient: nổi bật
fright: sợ hãi
majority: số đông
scars: vết sẹo
leeway: sự nới lỏng
touch point: điểm chạm
cooperation: sự hợp tác
reservation: đặt chỗ
capacity: dung tích, công xuất, năng lực
reconcile: hòa giải
summing: tổng hợp

exterminate: tiêu diệt
grand: vĩ đại
grant: khoản trợ cấp
grant me: ban cho tôi
taboo: điều cấm kị
adjacent: kề cận
coincidence: sự trùng hợp ngẫu nhiên
manufacture: sản xuất
credential: thông tin xác thực
identity: danh tính
exchange: trao đổi
asset: tài sản
learn about: tìm hiểu
protected: được bảo vệ
so: như vậy là
for example: chẳng hạn
grant permission: cấp quyền
