grace/gracefully: duyên dáng
lecture: bài giảng
tear: xé
generous: hào phóng
formular: công thức/kiểu như xây dựng
revive: hồi sinh
patching: vá lỗi
sanitize: vệ sinh
forgery: làm giả
constant: không thay đổi
có thể là liên lục như constantly
severity: mức độ nghiêm trọng 
bump up: va chạm lên

costly: tốn kém
broad term: thuật ngữ rộng
putting: đặt
exponential: theo cấp số nhân
peace of mind: sự bình yên trong tâm hồn
carry out/carried out: tiến hành
handy/handyman: tiện dụng/thợ sửa chữa
weakness: sự yếu đuối
like this: như thế này
notice: để ý
noticed: nhận thấy
therefore: do đó
used to: đã từng
overloaded: quá tải
security hole: lổ hổng bảo mật
the logger: nhật kí
aperture/hole: lổ hổng, hố, hang
trap: cái bẫy
get into: xâm nhập/truy cập