obsolete: lỗi thời
exclusively: độc quyền
throw away: vứt bỏ
fuzzy: mờ nhạt
take over: tiếp quản
occasional: thỉnh thoảng
hell out: cút đi
gently: nhẹ nhàng
place exclusive locks: đặt khóa độc quyền
immense: bao 

gotta create: phải tạo ra = must
pull that out: kéo cái đó ra
scrambled: tranh giành
masks: che giấu
as opposed: trái ngược
oppose: phản đối
whether: cho dù, liệu
shuffles: xáo trộn
cipher: mật mã

placed: được đặt
hence: kể từ đây
downstream: hạ lưu
warehouse operation: vận hành kho
driven: điều khiển
event driven: hướng sự kiện
order gets placed: đơn hang được đặt
loose coupling: liên kết lỏng lẻo
fallback: dự phòng
volatile: bay hơi
abundant: dồi dào
scarce: khan hiếm