swear to god: thề với chúa
prototyping: tạo mẫu
religion: tôn giáo
bare mental: kim loại trần
bare: trần trụi
barely: hầu như không
transport: vận chuyển
on it: trên đó
take you quite far: đưa bạn đi khá xa
practical: thực tế
a blueprint: một bản thiết kế
next: tiếp theo

Take a break: tạm nghĩ một chút
fixed: cố định
mount: gắn
a drive: ổ đĩa
recognize: nhận biết
recognizable: dễ nhận biết
match: khớp
it's time to: đã đến lúc để
get out of it: thoát khỏi nó
remote registry: sổ đăng kí từ xa

vocational: nghề nghiệp
transcription: phiên âm
radically: triệt để
miserable: khổ sở
bound: ràng buộc
boundless: vô biên, vô cùng
ramp up: tăng tốc
prizes: giải thưởng