kicked in: bị đá vào
probably: có lẽ
accommodation and flights: chỗ ở và chuyến bay
commute: đi lại
whether: liệu có nên
leniency: khoan dung
consistently refusing: liên tục từ chối
took me a while: mất của tôi một thời gian
shift: sự thay đổi, sự chuyển dịch
bust out of: thoát ra khỏi
someone: một người nào đó
make a decision: đưa ra quyết định
asked/ask me: yêu cầu tôi
teamates: đồng đội
primary: chủ yếu

come in: đến
deserted: vắng vẻ
I have to be on the phone: tôi phải trực điện thoại
fear: lo ngại
worry: lo lắng
regardless: bất kể
no matter: bất kể, không vấn đề gì
number of times: số lần
Hey, maybe you should: Này, có thể bạn nên
realization: hiện thực hóa
autonomy: tự chủ
Frequency of attendance at the office: tần xuất có mặt ở văn phòng
She doesn't have to be so difficult: Cô ấy không cần phải khó khăn như vậy

curly braces: {}
parentheses: ()
square brackets: []
punctuation: dấu câu