less powerful: yếu hơn
common/general-purpose: đa năng, mục đích chung
handle/process: xử lý
place/placed: nơi, vị trí/ được đặt
actually: thực ra
reality: thực tế
steeper: dốc hơn, độ dốc hơn
leaving me: khiến tôi, cho tôi
embarking: bước lên

resist: kháng cự
outright: hoàn toàn, không giấu giếm
keen on: quan tâm đến
keep on: tiếp tục
relative/relatively: tương đối
protocol suite: bộ giao thức
obligation: nghĩa vụ
talent acquisition: thu hút nhân tài
deconstruct: phá hủy
construct: xây dựng
coverage: phạm vi phủ sóng
freshness and timeliness: sự tươi mới và kịp thời
arrival of: xự xuất hiện của

interchange: trao đổi, hoán đổi
care about: quan tâm
serve: phục vụ
routing: định tuyến
moderate: vừa phải
consumer patterns: mẫu người tiêu dùng
fan out: quạt ra, phân luồng
on the orther hand: mặt khác
drawback: nhược điểm
variable: biến đổi
but instead of: mà thay vào đó
in time: trong thời gian, kịp thời
decouple: tách
