floppy: mềm dẻo
extensive area: khu vực rộng lớn
offset: bù lại
cryptography: mật mã học
feasibly: khả thi
rolling out: tung ra
fan out: quạt ra
Apparently: rõ ràng
Transient: thoáng qua
move on: tiến lên

purge: thanh lọc
in a sense: theo một nghĩa nào đó
neural network: mạng lưới nơ rông/thần kinh
delivery: phân phối
along with: cùng với
oversea: nước ngoài
fiber optic cable: cáp quang
cable: cáp
far apart: xa nhau
give way: nhường chỗ

corresponding/respective: tương ứng
Arithmetic: số học
control unit: bộ điều khiển
parallel and multitasking: song song và đa nhiệm
the rise: Sự gia tăng, tăng trưởng
in-depth: chuyên sâu
light intensity: cường độ ánh sáng
Mechanically: về mặt cơ học
render: hiển thị
serially: nối tiếp, tuần tự