chapter: chương
a bunch: một loạt
standpoint: quan điểm
every piece of code: mọi đoạn mã
mainly: chủ yếu
beast: quái vật
it fine: thì không sao
foreign: ngoại lai 
not really: không hẳn vậy
gate: cổng
experiment: thử nghiệm
cross-language: đa ngôn ngữ

ever exist: từng tồn tại
giant: khổng lồ
dramatically: đáng kể
stems: nguồn gốc, thân cây
notably: đáng chú ý
conservative: thận trọng
imposes: áp đặt
symbol: biểu tượng, kiểu kí hiệu
iconic: mang tính biểu tượng
retain: giữ lại

transmission: lây truyền
transit: quá cảnh
transiet: tạm thời
transition: chuyển tiếp
transform: chuyển đổi
move: di chuyển
fewer: ít hơn
many more: nhiều hơn
In terms of: về mặt
adventure: cuộc phiêu lưu
Ultimately: cuối cùng
fulfill: thực hiện
fulfilled/fulfillment: hoàn thành/sự hoàn thành