pitching: thuyết trình
dress code: quy định về trang phục
shift/shifting: sự thay đổi/chuyển dịch
biology: sinh vật
in the past: trong quá khứ
imposter: kẻ mạo danh
progressive: tiến bộ
bring: mang đến, đưa ra
dedicated to: dành riêng cho
argued to be: được cho là
dissatisfied: không hài lòng
opponents: đối thủ, người phản đối
According to: theo
right: đúng
well-known: nổi tiếng, biết đến
miss out: bỏ lỡ

enjoy the ride: tận hưởng chuyến đi
considered: được coi
show: cho thấy
activity: hoạt động
active: tích cực
outrun: vượt xa
ride: chuyến đi/lái
coming soon: sớm ra mắt
practical: thực tế
at most: nhiều nhất
disposal in heap: xử lý trong heap
as if: như thể, như là
out of the box: xuất xưởng
by default: theo mặc định
small number: số lượng nhỏ
is said: được cho là