exponentially: nhanh chóng
breakthrough: đột phá
beats: nhịp đập, đánh đập, đánh bại
continuations: tiếp tục
incident: sự cố
blowing up: thổi lên
spare: dự phòng
spare time: thời gian rảnh
natively: bản địa
inevitable: không thể tránh khỏi
ransomeware: phần mềm tống tiền
caption: chú thích
looking at: xem xét
carousel: băng chuyền
expected: dự kiến
form: biểu mẫu

hybrid: lai
citation: trích dẫn
undermine: làm suy yếu
ultra: cực kỳ
secure: chắc chắn, vững bền
plugged/plug in: cắm
abort: hủy bỏ
denotes: biểu thị
doubt: nghi ngờ
debase: làm suy yếu, làm mất giá trị
centuries: thế kỷ
politics: chính trị
eternal: vĩnh cửu
so on = early: sớm
directions=indirections: chỉ đường, chỉ dẫn
collision: va chạm