sequential: tuần tự
variety: đa dạng
variants: biến thể
variant: khác nhau
assembling: lắp ráp
plug and play: cắm và chạy
comprise: bao gồm
puzzle: câu đố
turn out: hóa ra
specific/specifically: cụ thể
permit: cho phép làm gì
acquire: có được
derive/deriving: nguồn gốc, lấy ra, rút ra
continuous: liên tục
rack: giá đỡ, vợt
further learning: tìm hiểu thêm

caveman: người tối cổ
gratitude: lòng biết ơn
shy: ngại ngùng
lost: mất
personal: cá nhân
annoy/annoying: khó chịu/làm phiền
tolerant: khoan dung, chịu đựng
built-in: được xây dựng sẵn
slash: chém, cắt
correlation: tương quan
tailored to: phù hợp với
liquid: chất lỏng
liquidity: thanh khoản, thanh lý
pioneer: tiên phong
regret: hối tiếc
