philosophy: triết lý
advoced: tán thành, ủng hộ
how often: bao lâu một lần
embrace failure: chấp nhận thất bại
setback = step back: trở ngại = lùi lại
right away: ngay lập tức
sketching: phác thảo
recharge: nạp năng lượng
muscle: cơ bắp
aspire/aspire to be: khao khát trở thành
take: lấy
    take off: cởi
shy/shy away: ngại/ngại tránh
as much as possible: càng nhiều càng tốt
arrive: đến nơi
arrange: sắp xếp

what matters: điều quan trọng
faith: niềm tin
try tackling projects that make you stretch: thử thực hiện các dự án giúp bạn vượt qua giới hạn của bản thân
comfort zone: vùng an toàn
obstacle: trở ngại
individual: cá nhân
    separate, separation, distinctive: riêng biệt, riêng rẽ
    apart: tách biệt, riêng biệt
    distinctive/distinguish: khác biệt/phân biệt
manifest: biểu hiện, minh bạch, rõ ràng
head to: hướng tới
offload: giảm tải, xả bớt
privacy policy: chính sách quyền riêng tư
orchestrating a brighter world: tổ chức một thế giới tươi sáng hơn
bridge: cầu nối
