support: ủng hộ
bet: cá cược
rectangles: hình chữ nhật
philosophies: triết lý
theorem: định nghĩa
look back: xem lại
media encoding: mã hóa phương tiện
compress: nén
computing: điện toán
take up less: chiếm ít hơn
There’s one more difference: Còn một điểm khác biệt nữa.
profit: lợi nhuận
progress: tiến bộ, tiến triển
purchases: mua hàng
sole proprietor: chủ sỡ hữu duy nhất
accessibility: khả năng tiếp cận

where: trong đó
negative user experience: trải nghiệm người dung tiêu cực
affect: ảnh hưởng
impact: tác động
resource-intensive: tốn nhiều tài nguyên
no matter which server: bất kể máy chủ nào
sales: doanh số
keep track: theo dõi
preferences: tùy chọn
exponentially: nhanh chóng theo cấp số nhân
groovy: thú vị, vui nhộn
come across: gặp phải
adversity: nghịch cảnh
despite: cho dù
despite of: mặc dù