decline: suy giảm, từ chối
perception: nhận thức
association: hiệp hội, sự liên kết
prize: giải thưởng
notable: đáng chú ý
incorporate: tích hợp, kết hợp
abundant: dồi dào, phong phú
redundant: dư thừa
face criticism: đối mặt với chỉ trích
drawback: nhược điểm
weakness: điểm yếu
intangible: vô hình

debate: tranh luận
argue that: lập luận rằng
dragging: kéo dài, trì trệ
aggressive: hung hăng, quyết liệt
effect/effective: tác dụng / hiệu quả
route: tuyến đường
blame: đổ lỗi, trách móc
accountability: trách nhiệm
accelerate: tăng tốc
accelerator: máy gia tốc
forbid/forbidden: cấm / bị cấm

internalized: tiếp nhận vào bên trong, thấm nhuần
put together: kết hợp, ghép lại
comprised: bao gồm
constitute: cấu thành
legacy: di sản
they remain critical: chúng vẫn giữ vai trò quan trọng
logical: hợp lý
indices: chỉ số
Put simply: nói đơn giản là
phrases: cụm từ
distinguish: phân biệt
in charge: chịu trách nhiệm