Self Taught Programmer Roadmap (That Gets you a Job) - English.txt

discouraging: làm nản long
intention: chủ đích
intent/intend: ý định
pursue: theo đuổi
humble: khiêm tốn
accountability: trách nhiệm giải trình
fork out that cash: bỏ số tiền mặt đó ra
revolves: quay vòng
constantly: liên tục
stay ahead: luôn dẫn đầu
dive/dig: lặn/đào
carefully: cẩn than
take away: lấy đi
expense: chi phí
pressure: áp lực
overwhelming: áp đảo
stumbled: vấp ngã
orchestration: phối hợp
once again: một lần nữa
mind/minded: tâm trí/có đầu óc
risk: rủi ro
privileged: đặc quyền
decent: tử tế
swarmed: tràn ngập
overlap: chồng chéo
discover: phát hiện
worth: đáng giá
worth taking time: đáng để dành thời gian
So definitely check that one out: vì vậy, chắc chắn kiểm tra cái đó
conception: quan niệm
misconception: quan niệm sai lầm

involve: liên quan
evolve/evolution: tiến hóa
revolution: cách mạng