strange: kỳ lạ
in the way: cản trở, gây cản trở
anticipate: dự đoán trước
predict: dự đoán
drastic: mạnh mẽ, quyết liệt
the joy: niềm vui
flip/flipped a word: đảo từ hoặc thay đổi thứ tự từ
polish and shine: trau chuốt, làm cho bóng bẩy
revised: được chỉnh sửa lại
capitalize: viết hoa, tận dụng
keep up: theo kịp, duy trì
insane: điên rồ, mất trí
backlog: tồn đọng, công việc bị dồn lại
next to: bên cạnh
pioneer: người tiên phong
accolades: sự ca ngợi, lời tán thưởng

comprising: bao gồm
exponential: tăng theo cấp số nhân
loyalty: sự trung thành
absence: sự vắng mặt
market capitalization: giá trị vốn hóa thị trường
mass consumption: tiêu thụ hàng loạt
undeniable: không thể phủ nhận
undoubtedly continue: chắc chắn sẽ tiếp tục
internet sector: lĩnh vực internet
prerequisite: điều kiện tiên quyết
acquisition: sự mua lại
the bulk: phần lớn
substantial/substantially: đáng kể
appeal: sức hút, thu hút
