confident of: tin tưởng
sick of: chán ngấy
hopeful of: hy vọng
capable of: có khả năng
certain/sure of: chắc chắn
joyful of: vui mừng
frighten of: hoảng sợ = fear = scare of
short of: thiếu, không đủ
agreeable to: có thể đồng ý
next to: kế bên
pleasant to: hài lòng
contrary to: trái lại, đối lập = contrast with
harmful to: có hại cho ai, cho cái gì
grateful for: biết ơn 
qualified for: có phẩm chất, đạt tiêu chuẩn
fit for: thích hợp cho
ready for: sẵn sàng cho
helpful/useful for: có lợi, lợi ích

clever at: khéo léo
clever: thông minh
amazed at: kinh ngạc
present at: hiện diện
delight with: vui mừng
confuse about: bối rối
rich in: giàu về
risk: rủi ro
absent from: vắng mặt
be kind, be nice: tử tế
prefer/preference: thích hơn, ưa thích
application for: đơn xin
redution/fall in: sự giảm / giảm trong
damage to: hư hại, thiệt hại
accuse: buộc tội
suspect=doubt
consist of: gồm có