blow up: phá hủy
break down: hư, hỏng
break in, break into: xông vào, đột nhập vào
break out: bùng nổ
break off: đột nhiên ngưng lại, kết thúc
break up/broken up: kết thúc
bring in: đưa ra, giới thiệu = introduce
burn out: thiêu cháy, thiêu rụi
carry on: tiếp tục
carry out: tiến hành
catch up/catch up with: bắt kịp, theo kịp
clear up: dọn dẹp = tidy, (thời tiết) sáng sủa hơn 
come across: tình cờ gặp
come along, come on: nhanh lên
come over: ghé nhà
come up: xảy ra
cut down, cut back: giảm bớt = reduce
cut off: ngừng cung cấp, cắt đứt
fill in: điền thông tin vào
fix up: sắp xếp, thu xếp = arrange

get by: xoay sở, đối phó = manage
get down: làm chán nản, làm thất vọng
get off: xuống, rời đi
get on: lên xe, tàu, máy bay
get over: vượt qua, khắc phục
give out: phân phát = distribute
give up: từ bỏ
go away: biến mất, tan đi = disappear
go on: tiếp tục
what are going on: cái gì đang xảy ra vậy?
hold on: đợi = wait
leave out: bỏ qua, bỏ quên = omit
look after: chăm sóc = take care of
look back: nhớ, nhớ lại = remember
look for: tìm kiếm = search, seek
look forward to: trông đợi
look into: điều tra = investigate
look up: tìm, tra cứu
make up: trang điểm, hóa trang | bịa đặt, sáng tác = invent

pick up: đón ai đó, cho đi nhờ xe
put off: hoãn lại = postpone, delay
run across, run into: tình cờ gặp ai
run out, run out of: hết, cạn kiệt
sell off: bán giảm giá
send for: mời đời, gọi đến, triệu tập
send out: mời đến, gọi đến, triệu tập = summon
shut up: ngừng nói
take off: cởi quần áo, máy bay cất cánh
take on: nhận, đảm nhận công việc
take over: đảm nhiệm, tiếp tục
thing over: suy nghĩ kĩ, cân nhắc = consider
throw away= throw out: ném đi, vứt đi = discard
try on: mặc thử quần áo
turn down: từ chối = refuse = denied, loại bỏ, bác bỏ = reject
turn into: trở thành, biến thành; chuyển thành = convert
turn on: mở, bật
turn off: tắt, khóa lại
turn up: đến = arrive; xuất hiện = appear
work out: tính toán = calculate
