estate: tài sản, bất động sản
away from the: xa khỏi
workout: buổi tập thể dục
sucks: thật tệ
velocity: vận tốc
hugging face: khuôn mặt ôm ấp (có thể là biểu cảm)
unpack: tháo dỡ, giải nén
stood out: nổi bật
possesses a wealth: sở hữu nhiều
it’s only a matter of time: chỉ là vấn đề thời gian
laid out: sắp xếp, bố trí
upbringing: sự nuôi dưỡng, giáo dục
signal/signaling: tín hiệu/phát tín hiệu
lean towards independent: nghiêng về độc lập
manifest: thu hút
miserable: đau khổ

guidance: sự hướng dẫn
nuclear: hạt nhân
beware of: cẩn thận với
monetize: kiếm tiền từ
apologise/apologize: xin lỗi
most like: rất giống
get through: vượt qua
late: trễ
later: sau này
lately: gần đây
latest: mới nhất
transit: quá cảnh, vận chuyển
spark: tia lửa, khơi mào

embrace: đón nhận
authentic: chân thật
awareness and conviction: nhận thức và niềm tin
imagery: hình ảnh tượng trưng
manifesting: thể hiện, biểu lộ
material/materialize: vật liệu, hiện thực hóa
the majority: đa số
approval/approve: chấp thuận, công nhận
have to: phải
on a whole: nói chung là
tidy, tidy up: gọn gàng, dọn dẹp
insane: điên rồ
traverse: vượt qua, đi qua
disaster: thảm họa