suck up/sucker: hút mát, kẻ hút máu
in the sense of: theo nghĩa của
sophisticated cyber attack: tấn công mạng tinh vi
guity: tội lỗi
greeter: người chào đón
is left: còn lại
anxiety: lo lắng
dramatic: kịch tính, diễn biến
being only: chỉ là
bold claim: tuyên bố táo bạo
falling behind: tụt hậu, tụt lại phía sau
growing and growing: ngày càng phát triển
break into, breakthrough: đột phá
holy: trời ơi
getting screwed: bị lừa
get through=overcome

hang out: tụ tập
resonated: đồng cảm, cộng hưởng
mandates: chỉ thị, mệnh lệnh, nhiệm vụ
bad guy: người xấu, kẻ xấu
getting cooked: bị nấu chín
analogy: sự tương tự
anxious=nervous
being mentioned: đang được đề cập
unorchestrated: không được dàn dung
widely: rộng rãi
unknowingly: vô tình, vô ý
revert: khôi phục
mirror: gương, bản sao
highlight: làm nổi bật
review: đánh giá
preview: xem trước