ruined: bị phá hủy
nearly: gần như
messed up: làm hỏng
conduct: chỉ đạo, cư xử
conducting: tiến hành
caused more damage: gây ra nhiều thiệt hại hơn
where I was involved: nơi tôi đã tham gia, liên quan
promising: triển vọng~potential
move into: bước vào
but there is a remarkable thing: Nhưng có một điều đáng lưu ý
breach~break: sự vi phạm
grateful: tri ân
time off: thời gian nghĩ
obsolete: cũ, lỗi thời
offsite: ngoài trang web

out the door: ra khỏi cửa
the evidence shows otherwise: bằng chứng cho thấy điều ngược lại
crowds get worse: đám đông trở nên tệ hơn
paid time off: thời gian nghỉ có lương
internal memos
insanely: điên rồ
biggest expense: chi phí lớn nhất
climbing up: leo lên
arbitrary performance: hiệu suất tùy ý
show up: xuất hiện
showcase: trưng bày lên
recognition~recognize: công nhận, nhận ra
stay in touch: giữ liên lạc
deliberately: cố ý <> accidently
never cross: không bao giờ vượt qua