strenghthen: tăng cường, củng cố
willpower: ý chí
add up: cộng lại
ego: cái tôi
drawing from: rút ra được
elastic: đàn hồi
Plastic: nhựa
Plasticity: Tính dẻo, dẻo dai
trails: đường mòn
just like: giống như
think of your brain
even more: thậm chí còn nhiều hơn
will get used to: sẽ dần quen
used to: đã từng
was: đã từng là

has worked: làm, hiệu quả
craft a: chế tạo một
almost: hầu hết, gần như
room: phòng
away: xa
less=fewer
least: ít nhất
crave: thèm
stock up: tích trữ
mindless: vô nghĩa
water bottle: chai nước
juice: nước ép
influencing/affect: ảnh hưởng
compromise: làm tổn hại, xâm phạm
consolidate=strengthen: củng cố