consequences: hậu quả
incentives to exploit it: khuyến khích và khai thác nó
exploit: khai thác	
tricked: bị lừa
accomplished: hoàn thành
simultaneously: đồng thời
agree: đồng ý
compromised: bị xâm phạm
arbitrary: bất kì
ownership: quyền sở hữu
opposed: phản đối
dispersed across distributed:  phân tán khắp nơi
dispersed: phân tán
govern: quản lý
transparency: minh bạch
closer: gần hơn
credible: đáng tin cậy

comparatively less: tương đối ít hơn
compilation : biên soạn
comparatively: tương đối
governance: quản trị
influence: ảnh hưởng
flaws: sai sót
cybercrime: tội phạm mạng
rising: trỗi dậy
consensus: đoàn kết
agreement: thỏa thuận
reliability: độ tin cậy 
tolerant: chấp thuận
emerge: nổi lên
conduct: chỉ đạo
interference: can thiệp
discover: phát hiện

rise: tăng lên
overcome: vượt qua
extent: mức độ
confident/confidentiality: tự tin/bảo mật
distance: khoảng cách
steady: vững chắc
revenue: doanh thu
decades: thập kỷ
idle: nhàn rỗi
destination: điểm đến
decision: quyết định
seamlessly: liền mạch
fundraising: gây quỹ
tradable: có thể giao dịch
transferrable: có thể chuyển nhượng
steal: ăn cắp
rely: phụ thuộc
brought: đem lại
comparatively: tương đối
resistant: kháng cự
