perhaps: có lẽ
inspire: truyền cảm hứng
eventually: sau cùng
mentality:  tâm lý
pretend: giả vờ
rubbish: rác
stucking: mắc kẹt
vision: tầm nhìn
anymore: nữa không
serious: nghiêm trọng
utility: thiết thực
supply: cung cấp
fill out: điền vào
suitable: thích hợp
situation: tình huống
reflect: phản ánh

integrity: chính trực
interpolation: phép nội suy
properly/poperly: đúng cách
mirror: gương
dirty: bẩn thỉu
serve: phục vụ
proceed: tiếp tục
brings us: mang đến cho chúng tôi
ties that bind: mối quan hệ ràng buộc
intergral: liên vùng
movement: chuyển động
crucial: chủ yếu
struggle: đấu tranh
suited: phù hợp
properly: đúng cách
decent: tử tế
discover: phát hiện
