corner: góc
horrible: tệ hại
side by side: cạnh bên nhau
as soon as: càng sớm càng
as well as: cũng như
as much as: nhiều như
huge: to lớn
philosophy: triết lý
truly: thực sự
adventure: cuộc phiêu lưu
over reliance: quá phụ thuộc
compatible: tương thích

benchmark: điểm chuẩn
incredible: đáng kinh ngạc
clarify: làm rõ
perspective: luật xa gần
manifast/manifest: rõ ràng
opinion: ý kiến
opinionated: khăng khăng cố chấp
mess/messing: sự lộn xộn
disaster: thảm họa
availability: khả dụng

replicating/replicate: nhân rộng
etc (ẹt xé te ra) : vân vân
risking/risk: mạo hiểm / rủi ro
fits: phù hợp
laid out: đặt ra
terms: điều kiện
termed: gọi là
directive: chỉ thị 
direct/directly: trực tiếp
directions: hướng đi/ phương hướng
provision: cung cấp = provide
theory: lý thuyết
