covering: che phủ
prepended: thêm vào trước
discrete: rời rạc
derive: lấy được
to sign: kí tên
funding it: tài trợ cho nó
will soon: sẽ sớm
held: cầm
compromised: bị xâm phạm
is critical that: điều quan trọng là
to prompt: nhắc nhở
remainder: phần còn lại
precisely: đúng
proceed: tiếp tục
rapidly: liên tục
arriving: đang đến

periodically: định kì
healing: đang lành lại
fund: nạp tiền
fiat: tiền pháp định
hang: treo
took too long: mất quá nhiều thời gian
dispense: phân chia
accumulate: tích trữ
prone: dễ bị
prompt: lời nhắc
decremented: giảm đi
vary: thay đổi
spec: thông số kĩ thuật
denominated: đặt tên
launch: phóng
audits and inspections: kiểm toán và thanh tra
