sick of: chán ngấy
potential: tiềm năng
considers: xem xét
corporation: tập đoàn
excited: hào hứng
confession: thú nhận, thú tội
mention: đề cập
grilty: nhiều sạn
vast: rộng lớn
dedicated: cống hiến, tận tụy
journey: hành trình
critical: phê bình
versatile: linh hoạt
redundant: dư thừa
massive: to lớn
orchestration: sự phối hợp
region: vùng đất
prompt: nhắc nhở, lời nhắc

crappy: dỡ tệ 
truly: thực sự
assist: hỗ trợ
treats: chiêu đãi
scaffold: khung
Attractive: hấp dẫn
Annual : hàng năm
agile: nhanh nhẹn
Troubleshoot: khắc phục sự cố
devise: nghĩ ra
attitude: thái độ
agency: chính hãng
cohesive: gắn kết
interfering: can thiệp
accordingly: tương ứng
subscibe: đặt mua
indicator: chỉ báo
