terms: điều kiện
term: thuật ngữ
mnemonic: ghi nhớ
recover: hồi phục
resistant: kháng cự
Treat: đối lý
cash: tiền mặt
steal: ăn cắp
consequences: hậu quả
proposed: đề xuất
remainder: phần còn lại
insufficient: không đủ
confusing: gây nhầm lẫn
adequate: không thỏa đáng
constructed: xây dựng
poorly: kém

fluctuate: dao động
predominantly: chủ yếu
precedence: quyền ưu tiên
plenty: nhiều
Furthermore: hơn nữa
destination: điểm đến
prominent: nổi bật
attention: chú ý
periodically: định kì
flawed: thiếu xót
incoming: mới đến
backward: phía sau
curious: tò mò
through: bởi vì
patient: kiên nhẫn
clipboard: bìa kẹp hồ sơ
