unsigned: chưa kí
denominations: giáo phái
scientific: có tính khoa học
colloquial: thông thường
basis: nền tảng
broadcast: phát tin
behalf: thay mặt
adapt: thích nghi
funds: quỹ
broad: rộng lớn
endorsement: sự chứng thực
Fortunately: may mắn thay
trust: tin cậy
Nevertheless: tuy nhiên
basket: rổ

companion: bạn đồng hành
briefly: tóm tắt
improvise: ứng biến
significant: có ý nghĩa
gained: đạt được
especially: đặc biệt
encrypte: mã hóa
drawer: ngăn kéo
impact: tác động
reveal: tiết lộ
revert: hoàn nguyên
malicious: độc hại
sneak: lén lút
funded: tài trợ
quotes: dấu ngoặc kép
