feasible: khả thi
zone: vùng
conform: tuân thủ
reside: cư trú
loose coupling: khớp nối lỏng lẻo
intact: nguyên vẹn
grab: lấy
ground up: nền tảng
stuck: mắc kẹt
enroll: tham gia, ghi danh
broker: người mua giới
enrich: làm giàu
relicate: tái hiện
relocate: di dời
massive: to lớn
tolenrance: sức chịu đựng

collapse: sụp đổ
intact: nguyên vẹn
ambitious: tham vọng
along the way: dọc đường
lack: thiếu
irregular: bất thường
inevitable: không thể tránh khỏi
counteract: chống lại
inherent: vốn có
auditing: kiểm toán
seamlessly: liền mạch
headaches: đau đầu
composite: hỗn hợp
Due to: do là
replicate: nhân rộng

