crucial: chủ yếu
no longer: không còn
survey: khảo sát
isolate: cô lập
monolithic: nguyên khối
obviously: rõ ràng
downside: nhược điểm
Awards and recognition: giải thưởng và giấy chứng nhận
Conducts: tiến hành
possess: sỡ hữu
compliant/compliance: tuân thủ
compliment: lời khen
closely: chặt chẽ == tightly
theory: lý thuyết
excellent: xuất sắc

Concrete: bê tông
accurate: chính xác
exceeded: vượt quá
curious: tò mò
assumption: giả định
assume: cho rằng
suppose: giả sử
delicious: thơm ngon
guess these: đoán những điều này
themselves: chúng tôi
crucial: chủ yếu
assist: hỗ trợ, trợ lý
despite: cho dù == althought
opinion: ý kiến
fantatic: tuyệt vời
intruction/instruct: hướng dẫn
