https://study4.com/tests/224/new-economy-toeic-test-1/

baking a crab: nướng cua
hammering: đập búa
Refreshments: giải khát
busy: bận
transit card: thẻ quá cảnh
elevator: thang máy
cash or check: tiền mặt hoặc séc
remarks: nhận xét
subway: tàu điện ngầm
flyers: tờ rơi
malfunctioned: trục trặc
anniversary: dịp kỉ niệm
opening ceremony: lễ khai mạc
famous novelist: tiểu thuyết gia nổi tiếng
Which seat is mine: chỗ ngồi nào là của tôi
seat: ghế ngồi, chỗ ngồi
rather slow: chậm hơn
extensive: rộng rãi, sâu rộng

coffee tastes: mùi vị cà phê
paycheck: tiền lương
promotion: khuyến mãi
concert: buổi hòa nhạc
get off: rời đi
come right this way: đi thẳng theo lối này
seminars: hội thảo
screw: vặn, tua vít
literary magazine: tạp chí văn học
Lecturer: giảng viên
Journalist: nhà báo
scale: tỷ lệ
eloquence: tài hùng biện
renovations: cải tạo, tu sửa
next meal: bữa ăn tiếp theo
meat: thịt
space: không gian
spacious: rộng rãi
Draft a budget: dự thảo, dự kiến danh sách

glad: vui mừng
have a moment: một chút thời gian
downtown: trung tâm thành phố
construction: xây dựng, thi công
tourists: khách du lịch
placed: đặt
ahead: trước
postpone: hoãn lại
husband: chồng
boardroom: phòng họp
traffic: giao thông...
traffic signs: biển báo giao thông
tags: thẻ, nhãn
confuse: nối rối
refuse: từ chối
upset: buồn bã
ever does get displeased: bao giờ cảm thấy không hài lòng
a theater: nhà hát
threat: mối đe dọa

citizens: công dân
resident: cư dân
mayor: thị trưởng
fundraiser: gây quỹ
reception: thu nhận, đón nhận
appeal: bắt mắt, thu hút
sign their children up: đăng kí cho con của họ
advertise: quảng cáo
regular: thường xuyên
vital data: dữ liệu quan trọng, thiết yếu
Portfolios: danh mục đầu tư
actors: diễn viên
excuse: thứ lỗi, tha lỗi
specialist: chuyên gia
in regard to: liên quan đến
furniture: nội thất
anticipate: đoán trước = guest
expansion: mở rộng
celebrity: người nổi tiếng
celebration: lễ ăn mừng, lễ kỉ niệm
celebrate: kỉ niệm